0,1,2,3,4,5,6,7,8,9,10,11
3,20,20,20,10,10,10,10,0,0,0,0
6,15,15,20,10,10,10,10,10,0,0,0
10,5,10,10,15,15,15,10,10,10,0,0
13,5,5,5,10,15,15,15,15,10,5,0
15,0,0,5,0,0,20,15,15,15,15,15
-1,0,0,0,5,10,15,0,0,15,25,30
